hello	merhaba
dinner	aksam yemegi
find	bulmak
end	son
car	araba
carpet	halı
water	su
funny	komik
read	okumak
question	soru
advanced	gelişmiş
impression	izlenim
prediction	tahmin
intention	niyet
data	veri
computer	bilgisayar
efficiency	verimlilik
consumption	tüketim
suitability	uygunluk
apple	elma
engineer	mühendis
yellow	sarı
bottle	şişe
keyboard	klavye
animal	hayvan
interface	arayüz
yellow	sarı
class	sınıf
library	kütüphane
mining	medencilik
